2111111011111
0000000000000
1111111011111
0000000000000
1110111111111
0000000000000
1111111111111
0000000000000
1111111111111
1111111111111
1111111111122
1111111111111
1111111111122